Japanese	Indonesia
=========================

------------- Bab 2  ------------
私		saya, aku
あなた		kamu, anda
名前		なまえ		nama
あの人		あのひと	orang itu
あの方		あのかた	orang itu(sopan)
~さん	sdr ~ (sufix untuk menyebut nama dengan sopan)
日本		にほん		jepang
にっぽん	jepang
韓国		かんこく	korea
中国		ちゅうごく	china, cina

はじめまして	perkenalkan (diucapkan saat membuka perkenalan diri)
~ちゃん		*pengganti ~san untuk anak-anak
~人		~じん		*sufiks untuk menyatakan kewarganegaraan
先生		せんせい	guru, dosen (tidak dipakai untuk orang pertama)
教師		きょうし	guru, dosen
問題		もんだい	soal 
質問		しつもん	pertanyaan
答え		こたえ		jawaban

学生		がくせい	pelajar, siswa
大学生		だいがくせい	mahasiswa
会社員		かいしゃいん	karyawan perusahaan
社員		しゃいん		karyawan perusahaan (disertai nama perusahaan)
はい		iya
いいえ		tidak, bukan
練習		れんしゅう	latihan
宿題		しゅくだい	pekerjaan rumah

銀行員		ぎんこういん	pegawai bank
銀行		ぎんこう	bank
病院		びょういん	rumah sakit
医者		いしゃ		dokter
学校		がっこう	sekolah
大学		だいがく	universitas
ありがとうございます		terima kasih
すみません	permisi (minta izin), maaf

研究者		けんきゅうしゃ	peneliti
誰		だれ		siapa
どなた		siapa (sopan)
はじめます	mari kita mulai
授業		じゅぎょう	pelajaran, kelas
失礼ですか	しつれいですか	maaf, permisi (untuk menanyakan hal pribadi)
～からきました	[saya] datang dari ~
ドイツ		jerman
タイ		thailand

おはよう[ございます]		selamat pagi
こんにちは	selamat siang, selamat sore (baca : konnichiwa)
こんばんは	selamat malam (baca : konbanwa)
おやすみなさい	selamat tidur
お願いします	おねがいします	tolong, mohon
インドネシア	indonesia
アメリカ	amerika
～歳		～さい		~tahun (umur)
何歳		なんさい	umur berapa
お幾つ		おいくつ	umur berapa (sopan)
イギリス	inggris
シンガポール	singapura
[どうぞ]よろしく[お願いします]	salam kenal(diucapkan saat menutup perkenalan)
こちらは～さんです		orang ini adalah ... (nama)

一		いち		satu, 1
二		に		dua, 2
三		さん		tiga, 3
四		し/よん		empat, 4
五		ご		lima, 5
六		ろく		enam, 6
七		なな/しち	tujuh, 7
八		はち		delapan, 8
九		きゅう		sembilan, 9
十		じゅう		sepuluh, 10
２０		にじゅう	dua puluh, 20
５５		ごじゅうご	lima puluh lima, 55

１歳		いっさい	1 tahun
２歳		にさい		2 tahun
８歳		はっさい	8 tahun
20歳		はたち		20 tahun
23歳		にじゅうさんさい	23 tahun


------------- Bab 3  ------------
これ		ini (dekat pembicara)
それ		itu (dekat lawan bicara)
あれ		itu (jauh dari pembicara dan lawan bicara)
どれ		mana?

本		ほん		buku
新聞		しんぶん	koran
名刺		めいし		kartu nama
あのう		eee, anu, maaf (ungkapan ragu ketika ingin memulai pembicaraan)
辞書		じしょ		kamus
カメラ		kamera
パソコン	personal komputer, laptop, pc
車		くるま		mobil
手帳		てちょう	buku agenda
カード		kartu
何		なに/なん	apa?

鉛筆		えんぴつ	pensil
ボールペン	bolpen, bolpoin
シャープペンシル		pensil mekanik
時計		とけい		jam
そう		begitu, iya, itu benar
そうですか	oh, begitu ya
違います	ちがいます	salah, bukan, tidak
どうぞ		silahkan (saat menawarkan barang)

英語		えいご		bahasa inggris
日本語		にほんご	bahasa jepang
～語		～ご		bahasa~
鍵		かぎ		kunci
ザッシ		majalah
傘		かさ		payung
これから、お世話になります	これから、おせわになります	mulai sekarang, mohon bimbingannya

かばん		tas
テレビ		televisi
スマホ		smartphone, hp
スマートフォン	smartphone, hp
バイク		sepeda motor
机		つくえ		meja
いす		kursi
お土産		おみやげ	oleh-oleh
こちらこそ[どうぞ]よろしく[お願いします]	balasan untuk yoroshiku onegaishimasu

# [こ/そ/あ/ど + の] diikuti kata benda #
この		~ini
その		~itu (dekat)
あの		~itu (jauh)
どの		~mana
ノート		buku catatan, note (setelapak tangan)
お菓子		おかし		amilan, makanan manis
チョコレート	cokelat
コーヒー	kopi
お茶		おちゃ		teh



------------- Bab 4  ------------
ここ		sini
そこ		situ (dekat)
あそこ		sana (jauh)
どこ		dimana?
教室		きょうしつ	ruang kelas
食堂		しょくどう	kantin, ruang makan, rumah makan
事務所		じむしょ	kantor
会議室		かいぎしつ	ruang rapat

こちら		sini (sopan)
そちら		situ (sopan)
あちら		sana (sopan)
どちら		mana (sopan)
受付		うけつけ	meja informasi, resepsionis
ロビー		lobi, ruang tunggu
部屋		へや		kamar
トイレ		toilet, wc, kamar kecil
おてあらい	toilet (sopan)

階段		かいだん	tangga
エレベーター	elevator, lift
エスカレーター	eskalator
レストラン	restoran
自動販売機	じどうはんばいき	mesin jual otomatis, vanding machine
電話		でんわ		telepon
お国		おくに		negara
家		うち		rumah
すみません	maaf, permisi

靴		くつ		sepatu
ネクタイ	dasi
服		ふく		baju, pakaian
ワイン		wine, anggur
売り場		うりば		tempat penjualan
地下		ちか		bawah tanah, basement
～階		～かい/～がい	lantai~, tingkat~
1階		いっかい	lantai satu, lantai 1
2階		にかい		lantai 2
何階		なんがい	lantai berapa
どうも		terima kasih (santai)

イタリア	italia
スウィス	swiss
フランス	perancis, france
玩具		おもちゃ	mainan
ジャカルタ	jakarta
バンコク	bangkok
ベルリン	berlin
新大阪		しんおおさか	shin-oosaka
文房具		ぶんぼうぐ	alat tulis, stationery
デパート	toserba, mall
化粧品		けしょうひん	kosmetik, makeup

～円		～えん		yen
いくら		berapa
百		ひゃく		~ratus, seratus, 100
２百		にひゃく	dua ratus, 200
３百		さんびゃく	tiga ratus, 300
６百		ろっぴゃく	enam ratus, 600
８百		はっぴゃく	delapan ratus, 800
千		せん		~ribu, seribu, 1000
２千		にせん		dua ribu, 2000
３千		さんぜん	tiga ribu, 3000
万		まん		~puluh ribu, sepuluh ribu, 10000
１万５千	いちまんごせん	lima belas ribu, 15000
いらっしゃいませ		selamat datang, welcome
[～を]見せてください		tolong perlihatkan ~
[～を]ください	minta~, tolong berikan [saya]~
じゃ		baiklah, kalau begitu

------------- Bab 5  ------------
今		いま		sekarang
～時		～じ		jam~
～分		～ふん/～ぷん	menit~
１時		いちじ		jam 1
２時		にじ		jam 2
４時		よじ		jam 4
７時		しちじ		jam 7
９時		くじ		jam 9
１分		いっぷん	menit 1
２分		にふん		menit 2
３分		さんぷん	menit 3
４分		よんぷん	menit 4
５分		ごふん		menit 5
６分		ろっぷん	menit 6
７分		ななふん	menit 7
８分		はっぷん	menit 8
９分		きゅうふん	menit 9
10分		じっぷん/じゅっぷん	menit 10
２７分		にじゅうななふん	menit 27
半		はん		setengah (waktu)
７時半		しちじはん	7.30, tujuh lewat tiga puluh menit, setengah delapan
何時		なんじ		jam berapa
何分		なんぷん	berapa menit
午前		ごぜん		AM (sebelum jam 12 siang, 00.00-11.59)
午後		ごご		PM (setelah jam 12 siang, 12.00-23.59)

月曜日		げつようび	hari senin
火曜日		かようび	hari selasa
水曜日		すいようび	hari rabu
木曜日		もくようび	hari kamis
金曜日		きんようび	hari jumat
土曜日		どようび	hari sabtu
日曜日		にちようび	hari minggu
朝		あさ		pagi
昼		ひる		siang

～から		dari~
～まで		sampai~
夕方		ゆうがた	sore
晩		ばん		malam
毎朝		まいあさ	setiap pagi
毎晩		まいばん	setiap malam
毎日		まいにち	setiap hari
起きます	おきます	bangun
寝ます		ねます		tidur

明日		あした		besok
あさって	lusa
今朝		けさ		tadi pagi
今晩		こんばん	malam ini, nanti malam
デパート	toserba, mall
銀行		ぎんこう	bank
郵便局		ゆうびんきょく	kantor pos
図書館		としょかん	perpustakaan, library
美術館		びじゅつかん	gedung kesenian

働きます	はたらきます	bekerja
休みます	やすみます	beristirahat, berlibur (KK)
勉強します	べんきょうします	belajar
終わります	おわります	selesai
休み		やすみ		istirahat, cuti, libur (KB)
昼休み		ひるやすみ	istirahat siang
今日		きょう		hari ini
昨日		きのう		kemarin
おととい	kemarin lusa, dua hari yang lalu

ロンドン	london
試験		しけん		ujian, test
会議		かいぎ		rapat (~wo shimasu : melakukan rapat)
映画		えいが		film
番号		ばんごう	nomor
何番		なんばん	nomor berapa
そちら		disitu
大変		たいへん	berat, sulit
～と～		~ dan ~ (digunakan untuk menyambung kata benda)


------------- Bab 6  ------------
行きます	いきます	pergi
来ます		きます		datang
帰ります	かえります	pulang
学校		がっこう	sekolah
スーパー	pasar swalayan, supermarket
駅		えき		stasiun
先週		せんしゅう	minggu lalu
今週		こんしゅう	minggu ini
来週		らいしゅう	minggu depan

飛行機		ひこうき	pesawat terbang
舟		ふね		kapal laut
電車		でんしゃ	kereta rel listrik
地下鉄		ちかてつ	kereta bawah tanah
先月		せんげつ	bulan lalu
今月		こんげつ	bulan ini
来月		らいげつ	bulan depan

新幹線		しんかんせん	shinkansen
バス		bus
タクシー	taksi
自転車		じてんしゃ	sepeda
歩いて		あるいて	dengan berjalan kaki
誕生日		たんじょうび	ulang tahun
去年		きょねん	tahun lalu
今年		ことし		tahun ini
来年		らいねん	tahun depan
人		ひと		orang
友達		ともだち	teman
彼		かれ		dia (laki-laki)
彼女		かのじょ	dia (perempuan)
家族		かぞく		keluarga
一人で		ひとりで	sendirian
普通		ふつう		biasa
急行		きゅうこう	ekspress

~年		～ねん		tahun~
何年		なんねん	tahun berapa
～月		～がつ		bulan~
１月		いちがつ	bulan 1, januari
４がつ		しがつ		bulan 4, april
７がつ		しちがつ	bulan 7, juli
９がつ		くがつ		bulan 9, september
何月		なんがつ	bulan apa?
～日		～にち		~hari, tanggal~
何日		なんにち	tanggal berapa, berapa hari
いつ		kapan?

１日		ついたち	tanggal 1
２日		ふつか		tanggal 2
3日		みっか		tanggal 3
4日		よっか		tanggal 4
5日		いつか		tanggal 5
6日		むいか		tanggal 6
7日		なのか		tanggal 7
8日		ゆうか		tanggal 8
9日		ここのか	tanggal 9
１０日		とおか		tanggal 10
１４日		じゅうよっか	tanggal 14
20日		はつか		tanggal 20
２４日H		にじゅうよっか	tanggal 24

フリーマーケット	flea market, free market
そうですね		ya betul, ya begitulah
[どうも]ありがとうございます	terima kasih [banyak]
どういたしまして	sama-sama, you are welcome, my pleasure
～番線		～ばんせん	peron nomor~, gerbong nomor~
次の		つぎの		selanjutnya
とっきょう	super ekspres



------------- Bab 7  ------------
食べます	たべます	makan
飲みます	のみます	minum
吸います	すいます	menghisap
見ます		みます		melihat, menonton
聞きます	ききます	mendengar
読みます	よみます	membaca
書きます	かきます	menulis
描きます	かきます	menggambar
買います	かいます	membeli
取ります	とります	mengambil
合います	あいます	bertemu
します		melakukan, mengerjakan, berbuat
テニス		tenis

サッカー	sepak bola, soccer, football
お花見		おはなみ	menikmati bunga sakura
タバコ		rokok
手紙		てがみ		surat
レポート	laporan
写真		しゃしん	foto
ビデオ		video
何		なに/なん	apa?
ご飯		ごはん		nasi
朝ご飯		あさごはん	sarapan
昼ご飯		ひるごはん	makan siang
晩ご飯		ばんごはん	makan malam

パン		roti
卵		たまご		telur
肉		にく		daging
魚		さかな		ikan
野菜		やさい		sayur
果物		くだもの	buah-buahan
水		みず		air
お茶		おちゃ		teh, teh jepang
紅茶		こうちゃ	teh merah
ミルク		susu
牛乳		ぎゅうにゅう	susu
ジュース	jus
ビール		bir
お酒		おさけ		sake, minuman keras

店		みせ		toko
庭		にわ		halaman (rumah)
メキシコ	meksiko
一緒に		いっしょに	bersama-sama
ちょっと	sebentar, sedikit
いつも		selalu
時々		ときどき	kadang-kadang, sometimes
これから	setelah itu, kemudian
ええ		iya (santai)
いいですね	bagus ya, baik ya
なんですか	apa?
じゃ、また[明日]	ok, sampai jumpa[besok]
分かりました	わかりました	mengerti, baik


------------- Bab 8  ------------
切ります	きります	menggunting, memotong
送ります	おくります	mengirim, mengantar
あげます	memberikan
もらいます	mendapatkan, menerima
貸します	かします	meminjamkan, menyewakan
借ります	かります	meminjam, menyewa
教えます	おしえます	mengajar
習います	ならいます	belajar (dengan tutor)
電話をかけます	menelepon
手		て		tangan
箸		はし		sumpit
スプーン	sendok

ナイフ		pisau, knife
フォーク	garpu, fork
ハサミ		gunting
ケータイ	HP
メール		email
年賀状		ねんがじょう	kartu tahun baru
パンチ		pelubang kertas
ホチキス	staples, stapler
セロテープ	selotip
消しゴム	けしごむ	penghapus karet, eraser

髪		かみ		kertas
花		はな		bunga
プレセント	present, hadiah, kado
荷物		にもつ		barang
お金		おかね		uang
父		ちち		bapak, ayah
母		はは		ibu
お母さん	おかあさん	ibu orang lain (panggilan untuk ibu kandung sendiri)
お父さん	おとうさん	ayah orang lain (panggilan untuk ibu kandung sendiri)
クリスマス	natal, christmas
きっぷ		karcis, tiket
シャツ		kemeja, kaos
もう		sudah
まだ		belum
これから	mulai sekarang
～素敵ですね	～すてきですね	~bagus ya
いらっしゃい	selamat datang
どうぞおあがりください		silahkan masuk
失礼します	しつれいします	permisi
[～は]いかがですか	bagaimana [~]
頂きます	いただきます	selamat makan
ごちそうさま[でした]		terima kasih atas hidangannya


------------- Bab 9  ------------
ハンサム[na]	ganteng, tampan, gagah
きれい[na]	bersih, cantik
しずか[na]	tenang, sunyi
賑やか[na]	にぎやか	ramai
有名[na]	ゆうめい	terkenal
親切[na]	しんせつ	baik hati (tidak digunakan untuk keluarga sendiri)
元気[na]	げんき		sehat walafiat
暇[na]		ひま		senggang, luang, waktu luang
便利[na]	べんり		praktis
素敵[na]	すてき		bagus
大きい		おおきい	besar
小さい		ちいさい	kecil
新しい		あたらしい	baru
古い		ふるい		lama, tua
いい		baik, bagus
良い		よい		baik, bagus
悪い		わるい		buruk, jelek
暑い		あつい		panas
寒い		さむい		dingin (cuaca)
冷たい		つめたい	dingin (benda)

難しい		むずかしい	sulit, susah
優しい		やさしい	mudah, gampang
高い		たかい		mahal, tinggi
安い		やすい		murah
低い		ひくい		rendah
面白い		おもしろい	menarik
美味しい	おいしい	enak
あまり		kurang begitu~, tidak begitu~ (diikuti kalimat negatif)
とても		sangat, ~sekali (digunakan sebelum kata sifat)
忙しい		いそがしい	sibuk
楽しい		たのしい	senang
白い		しろい		putih
黒い		くろい		hitam
青い		あおい		biru
赤い		あかい		merah
緑		みどり		hijau
桜		さくら		sakura
山		やま		gunung
町		まち		kota
食べ物		たべもの	makanan
飲み物		のみもの	minuman

所		ところ		tempat
寮		りょう		asrama
生活		せいかつ	kehidupan
お仕事		おしごと	pekerjaan
どう		bagaimana?
どんな～	yang bagaimana~
そして		kemudian, dan (digunakan untuk menyambung kalimat)
～が		~, tetapi~ (di tengah kalimat)
お元気ですか	apa kabar?
～もういっぱいいかがですか	mau tambah~ secangkir lagi?
もう～です[ね]	sudah ~[ya]
そろそろしつれいします		maaf, saya mau pamit dulu
いいえ		sama-sama
またいらしゃってください	silahkan datang lagi
シャンハイ	sanghai
金閣寺		きんかくじ	kuil kinkakuji

===HERE===

------------- Bab 10  ------------
wakarimasu	mengerti
arimasu		ada, mempunyai (benda mati)
suki[na]	suka, gemar
kirai[na]	tidak suka, benci
jouzu[na]	pintar, pandai 
heta[na]	tidak pandai, tidak pintar
nomimono	minuman
ryouri		masakan
supo-tsu	sport, olahraga
yakyuu		bisbol, baseball

dansu		dansa
ryokou		tamasya, trip, travel
ongaku		musik
uta		lagu
kurasikku	klasik 
jazzu		jaz
karaoke		karaoke
e		gambar
kabuki		kabuki (salah satu drama tradisional jepang)
ji		huruf
goshujin	suami (digunakan untuk menyebutkan suami orang lain)

otto		suami
shujin		suami
okusan		istri (digunakan untuk menyebutkan suami orang lain)
tsuma		istri
kanai		istri
kodomo		anak
yoku		dengan baik
daitai		kira-kira, kurang lebih
takusan		banyak
sukoshi		sedikit
zenzen		sama sekali (diikuti kalimat negatif)
hayaku		dengan cepat

jikan		waktu, jam
gurai		kurang lebih, sekitar, kira-kira
~kara		karena~, sebab~
kanji		kanji
hiragana	hiragana
katakana	katakana
ro-maji		romaji, huruf latin
omakai okane	uang kecil, uang receh
chiketto	tiket
youji		urusan
yakusoku	janji

arubaito	kerja paruh waktu, kerja sampingan, part time
doushite	kenapa?
kashite kudasai	tolong pinjamkan
iidesuyo	boleh
zannendesu[ga]	sayang sekali
aa		oh, aa
isshoni ikagadesuka	bagaimana kalau bersama-sama?
~ha chotto	maaf ya, saya tidak bisa~
damedesuka	tidak bisa ya?, tidak boleh ya?
matakondo onegaishimasu	maaf, lain kalisaja






------------- Bab 11  ------------
arimasu		ada (benda mati)
imasu		ada (benda hidup)
iroiro[na]	berbagai
otokonohito	orang laki-laki
onanohito	orang perempuan
otokonoko	anak laki-laki
onanoko		anak perempuan
inu		anjing
neko		kucing
panda		panda
zou		gajah
ki		pohon

mono		barang
denchi		baterai
hako		kotak
suicchi		tombol, saklar
reizouko	kulkas, lemari es
te-buru		meja makan
beddo		bed, tempat tidur
tana		lemari
doa		pintu
mado		jendela
posuto		kotak surat, kotak pos
biru		gedung

konbini		toko 24 jam, swalayan, indomaret
kouen		taman (publik, umum)
kissaten	kedai kopi, coffee shop
~ya		toko~
kutsuya		toko sepatu
noriba		tempat naik
ue		atas
shita		bawah
mae		depan
ushiro		belakang
migi		kanan
hidari		kiri

naka		dalam, di dalam
soto		luar
tonari		sebelah
chikaku		dekat
aida		antara
ken		prefektur, provinsi
[doumo]sumimasen	terima kasih [banyak]
nanpura-	kecap ikan
ko-na-		tempat, bagian penjualan
ichiban shita	paling bawah
toukyoudizuni-rando	tokyo disneyland
~ya~[nado]	~dan ~[dan lain-lain]









------------- Bab 12  ------------
[ga]imasu	ada, mempunyai (kepemilikan)
[ni]imasu	ada (keberadaan)
kakarimasu	memakan, perlu (digunakan untuk waktu dan uang)
[wo]yasumimasu	tidak masuk~
ringo		apel
ikutsu		berapa (banyak)
hitori		seorang
futari		dua orang
~nin		~orang

hitotsu		1 buah/benda
futatsu		2 buah/benda
mittsu		3 buah/benda
yottsu		4 buah/benda
itsutsu		5 buah/benda
muttsu		6 buah/benda
nanatsu		7 buah/benda
yattsu		8 buah/benda
kokonotsu	9 buah/benda

~dai		~ buah (kata bantu bilangan untuk menghitung mesin dan mobil)
nidai		2 buah (mesin)
~mai		~lembar, ~helai
~kai		~kali
ikkai		1 kali
rokkai		6 kali
hakkai		8 kali
hachikai	8 kali
jukkai		10 kali

mikan		jeruk
sandoicchi	sandwich
kare-[raisu]	[nasi dan] kare
aisukuri-mu	es krim
kitte		perangko
hagaki		kartu pos

fuutou		amplop
ryoushin	orang tua
kyoudai		saudara, saudari
ani		kakak laki-laki (untuk kakak sendiri)
onisan		kakak laki-laki (untuk kakak orang lain)
ane		kakak perempuan (untuk kakak sendiri)
onesan		kakak perempuan (untuk kakak orang lain)
otouto		adik laki-laki (adik sendiri)
otoutosan	adik laki-laki (adik orang lain)
imouto		adik perempuan (adik sendiri)
imoutosan	adik perempuan (adik orang lain)
gaikoku		luar negeri, negara asing
ryuugakusei	pelajar asing
kurasu		kelas
~jikan		~jam
~shuukan	~minggu
isshuukan	satu minggu, 1 minggu
~kagetsu	~bulan
ikkagetsu[kan]	[selama] 1 bulan
rokkagetsu[kan]	[selama] 6 bulan
hakkagetsu[kan]	[selama] 8 bulan
hachigetsu[kan]	[selama] 8 bulan
jukkagetsu[kan]	[selama] 10 bulan

~nen		~tahun
~gurai		kira-kira~
donokurai	berapa lama
zenbude		semua
minna		semuanya (orang)
~dake		hanya, ~saja
kashikomarimashita	baik (bentuk sopan wakarimashita)
ii[o]tenkidesune	cuacanya bagus ya
funabin		pos laut, pelabuhan

odekakedesuka	mau keluar?
chotto ~made	ke~ sebentar
itterasshai	hati-hati
ittekimasu	saya berangkat
koukuubin	pos udara, bandara
eame-ru		pos udara, bandara
onegaishimasu	tolong
o-sutoraria	australia








------------- Bab 13  ------------
kantan[na]	mudah, gampang
chikai		dekat
tooi		jauh
hayai		cepat (早い:cepat dalam waktu; 速い:cepat dalam kecepatan benda)
osoi		lambat
ooi		banyak (benda hidup)
sukunai		sedikit (benda hidup)
atatakai	hangat (暖かい:suhu ruangan; 温かい:benda)
suzushii	sejuk

amai		manis
karai		pedas
omoi		berat
karui		ringan
[~ga]ii		lebih baik, baik
kisetsu		musim
haru		musim semi
natsu		musim panas
aki		musim gugur

fuyu		musim dingin
tenki		cuaca
ame		hujan
yuki		salju
kumori		mendung
hoteru		hotel
kuukou		bandara
umi		laut

sekai		dunia
pa-ti-		pesta
[o]matsuri	perayaan
sukiyaki	sukiyaki (makanan daging sapi dan sayur dalam panci)
sashimi		sashimi (ikan mentah yang dipotong tipis)
[o]sushi	sushi (nasi dicampur cuka yang didalamnya diberi ikan mentah)
tenpura		tempura (gorangan sari laut dan sayur yang dipakai tepung teriku)
buta niku	daging babi
tori niku	daging ayam

ichiban		paling
ikebana		seni merangkai bunga
dochira		yang mana
dochiramo	dua-duanya, yang mana juga
zutto		jauh lebih, terus terusan
momiji		maple, daun yang berubah warna menjadi merah
gyuuniku	daging sapi
remon		lemon
hajimete	untuk pertama kali

tadaima		saya kembali, saya pulang
okaerinasai	selamat datang kembali, sudah pulang ya
waa, sugoihitodesune	wah, banyak orang
tsukaremashita	lelah
gionmatsuri	perayaan Gion
honkon		hongkong
shingapo-ru	singapura
~yori		daripada~










------------- Bab 14  ------------
asobimasu	bermain
oyogimasu	berenang
mukaemasu	menjemput (mukae ni ikimasu : pergi menjemput)
tsukaremasu	lelah (jika keadaan lelah : tsukaremshita)
kekkonshimasu	menikah
[~ga]hoshii	ingin~, mau~

shokujishimasu	makan (tanpa objek)
sanposhimasu	berjalan-jalan (~wo sanposhimasu : berjalan-jalan di~)
taihen[na]	berat, susah
kaimonoshimasu	berbelanja
hiroi		luas
semai		sempit
pu-ru		kolam renang, pool

kawa		sungai
bijutsu		seni, art
tsuri		pancing (tsuri wo shimasu : memancing)
suki-		ski (suki- wo shimasu : bermain ski)
shuumatsu	akhir pekan, weekend
[o]shougatsu	tahun baru, new year

~goro		sekitar~, kira-kira
nanika		sesuatu
dokoka		suatu tempat
nodoga kawakimasu	haus (jika keadaan haus : nodoga kawakimashita)
onakaga sukimasu	lapar (jika keadaan lapar : onakaga sukimashita)
soushimashou	ya, mari (digunakan untuk menyetujui aksi yang disarankan)

gochuumonha	mau pesan apa? (baca gochuumonwa)
teishoku	menu paket
gyuudon		gyudon
[shoushou]omachidekudasai	tunggu[sebentar]
~de gozaimasu	(bentuk halus dari desu)
betsubetsuni	sendiri-sendiri, masing-masing









------------- Bab 15  ------------
tsukemasu[2]	menyalakan, memasang, menghidupkan
keshimasu[1]	mematikan, memadamkan
akemasu[2]	membuka
shimemasu[2]	menutup
isogimasu[1]	buru-buru
machimasu[1]	menunggu
mochimasu[1]	membawa
torimasu[1]	mengambil
tetsudaimasu[1]	membantu
yobimasu[1]	memanggil
hanashimasu[1]	berbicara
tsukaimasu[1]	menggunakan
tomemasu[2]	menghentikan, memarkir
misemasu[2]	memperlihatkan
oshiemasu[2]	memberitahukan
suwarimasu[1]	duduk

tachimasu[1]	berdiri
hairimasu[1]	masuk
demasu[2]	keluar
furimasu[1]	turun (ame ga furimasu, yuki ga furimasu)
kopi-shimasu[3]	fotokopi
denki		listrik, lampu
eakon		AC
pasupo-to	pasport, paspor
namae		nama
jyuusho		alamat, address
chizu		peta, map
shio		garam
satou		gula
mondai		masalah, soal
kotae		jawaban

yomikata	cara membaca
~kata		cara~
massugu		lurus
yukkuri		pelan-pelan
sugu		segera, langsung
mata		lagi
atode		nanti
mousukoshi	sedikit lagi
mou~		~lagi
saa		mari (digunakan untuk mengajak atau menyuruh sesuatu kepada lawan bicara)
are?		ah? (digunakan ketika heran, kaget,  atau merasa aneh)
shingou		lampu lalu lintas
magarimasu	belok
korede onegaishimasu	minta dengan ini
otsuri		uang kembalian









------------- Bab 16  ------------
okimasu		meletakkan, menaruh
tsukurimasu	membuat, membangun, memproduksi (作ります:dengan tangan; 造ります:dengan mesin)
urimasu		menjual
shirimasu	mengetahui, mengenal
sumimasu	tinggal

kenkyuushimasu	meneliti
shiryou		data, bahan
katarogu	katalog
jikokuhyou	jadwal
fuku		baju, pakaian
seihin		produk

sofuto		software, perangkat lunak
denshijisho	kamus elektronik
keizai		ekonomi
shakusho	kantor walikota
koukou		SMA, senior high school
kaisha		dokter gigi








------------- Bab 17  ------------
norimasu	naik (kendaraan)
orimasu		turun (kendaraan)
norikaemasu	ganti, pindah (kendaraan)
abimasu		mandi (shawa- wo abimasu : mandi)
iremasu		memasukkan
dashimasu	mengeluarkan, menyerahkan, mengirim
oroshimasu	mengeluarkan, mengambil (uang)
hairimasu	masuk
daigaku		universitas
demasu		keluar, turun
oshimasu	menekan
nomimasu	minum
hajimemasu	mulai
kengakushimasu	mengunjungi
denwashimasu	menelepon
wakai		muda
nagai		panjang
mijikai		pendek

akarui		terang
kurai		gelap
karada		badan
atama		kepala
kami		rambut
kao		muka
me		mata

mimi		telinga
hana		hidung
kuchi		mulut
ha		gigi
onaka		perut
ashi		kaki
se		punggung
sa-bisu		pelayanan
jogingu		jogging, lari pelan-pelan
shawa-		shower

midori		hijau
[o]tera		wihara
jinsha		kuil shinto
~ban		nomor~
douyatte	dengan cara bagaimana? (dipakai untuk menanyakan cara pergi ke suatu tempat atau cara untuk melakukan sesuatu)
dono~		~yang mana (mengungkapkan lebih dari tiga barang/waktu) (dengan KB)
dore		mana (mengungkapkan lebih dari tiga barang)(tanpa KB)
sugoidesune	hebat ya
[iie,]madamadadesu	tidak, belum memuaskan (digunakan untuk merendah)
ohikidashimasuka	mau menarik uang?
mazu		pertama-tama, terlebih dahulu
tsugini		kemudian, selanjutnya
kyasshuka-do	kartu ATM
anshoubangou	PIN
kingaku		jumlah uang
kakunin		cek
botan		tombol, button









------------- Bab 18  ------------
oboemasu	mengingat, menghafal
wasuremasu	lupa
nakushimasu	kehilangan
haraimasu	membayar
kaeshimasu	mengembalikan
dekakemasu	keluar, pergi, berangkat
nugimasu	buka (baju, sepatu, dll)
motteikimasu	membawa pergi
mottekimasu	membawa datang
shinpaishimasu	mengkhawatirkan
zangyoushimasu	lembur
shucchoushimasu	dinas
nomimasu	minum (air, obat, dll)
hairimasu	masuk
taisetsu[na]	penting, bernilai, berharga
daijoubu[na]	tidak apa-apa, tidak masalah

abunai		bahaya
kinen		dilarang merokok
hokenjo		kartu asuransi
kenkou		kesehatan
netsu		demam
hyouki		sakit
kusuri		obat
[o]furo		mandi, kamar mandi, bathup

uwagi		baju, jaket
shitagi		pakaian dalam
doushimashitaka	kenapa?, ada masalah apa?
nodo		kerongkongan, tenggorokan
[~ga]itaidesu	~sakit
kaze		demam, masuk angin
sorekara	dan, kemudian
odaijini	semoga lekas sembuh, get well soon











------------- Bab 19  ------------
dekimasu	dapat, bisa
araimasu	mencuci
hikimasu	bermain (alat musik)
utaimasu	bernyanyi
atsumemasu	mengumpulkan
sutemasu	membuang
kaemasu		mengganti, menukar
untenshimasu	menyetir, mengendarai
yoyakushimasu	memesan
piano		piano

~me-toru	meter
genkin		uang tunai
syumi		hobi, gemar
nikki		catatan harian, diary
oinori		doa (~wo shimasu : berdoa)
furusato	kampung halaman
kacyou		kepala seksi
bucyou		kepala bagian
jyacyou		direktur utama

doubutsu	hewan, binatang
uma		kuda
mukashi		jaman dahulu
inta-netto	internet
tokuni		terutama, khususnya
hee		betul ya?, benar ya?, masa!
omoshiroi	menarik (sorewa omoshiroi desune : itu menarik ya)
nakanaka	jarang, tidak mudah(diikuti bentuk negatif)
hontoudesuka	benar?, betul?
zehi		benar-benar, mesti



------------- Bab 20 ------------
noborimasu	naik
tomarimasu	menginap(di hotel)
soujishimasu	membersihkan
sentakushimasu	mencuci pakaian
narimasu	menjadi
nemui		mengantuk
tsuyoi		kuat
yowai		lemah
toukyou		tokyo

rensyuu		latihan (~wo shimasu : berlatih)
gorufu		golf (~wo shimasu : bermain golf)
sumou		sumo (~wo shimasu : bermain sumo)
ocha		teh
hi		hari
cyoushi		kondisi
ichido		sekali
ichidomo	satu kalipun, tidak sama sekali(diikuti bentuk negatif)

dandan		berangsur-angsur, lama-kelamaan
mousugu		tidak lama lagi
okagesamade	atas berkat(ucapan yang digunakan ketika menyatakan rasa terima kasih atas bantuan atau kebaikan hati dari orang)
demo		tetapi
kanpai		toast, bersulang
daietto		diet (~wo shimasu : berdiet)
muri[na]	paksa, berlebihan, tidak mungkin
kara da ni ii	baik untuk tubuh







------------- Bab 21 ------------
irimasu		memerlukan
shirabemasu	memeriksa, meneliti, mengecek
syuurishimasu	memperbaiki
boku		aku (laki-laki, informal dari watashi)
kimi		kamu (informal dari anata)
~kun		saudara ~ (informal dari san, sering digunakan untuk nama anak laki-laki)
un		ya (informal dari はい)
uun		tidak, bukan (informal dari いいえ)
kotoba		kata, bahasa
kimono		kimono (pakaian tradisional jepang)
biza		VISA
hajime		awal, mula-mula
owari		akhir
kocchi		sini (informal kochira)
sochhi		situ (informal sochira)
acchi		sana (informal achira)
docchi		mana (informal dochira)
minnade		kita semua, kita sama-sama
~kedo		~tetapi (informal dari が)
onakagaippaidesu	sudah kenyang
yokattara	kalau mau, kalau suka
iroiro		macam-macam





------------- Bab 22 ------------
omoimasu        mengira
iimasu		mengatakan
kachimasu	menang
makemasu	kalah
arimasu		ada, diadakan
yakunitachimasu	berguna, bermanfaat
ugokimasu	pindah, bergerak
yamemasu	berhenti
kiwotsukemasu	berwaspada, berhati-hati
ryougakusimasu	studi di luar negeri
muda[na]	sia-sia. Tidak berguna
uben[na]	tidak praktis
sugoi		hebat
hontou		betul

uso		bohong
jidousya	mobil
koutsuu		lalu lintas
bukka		harga barang
bousou		siaran, pengumuman
nyuusu		berita
shinjimasu	mempercayai
anime		animasi jepang
manga		manga, komik
dezain		desain
yume		mimpi
tensai		genius
shiai		pertandingan (~ wo shimasu : bertanding)
iken		pendapat
hanashi		cerita (~ wo shimasu : bercerita, berbicara)

chikyuu		bumi
tsuki		bulan
kaguyahime	cerita legenda jepang
bokushi		pastur, pendeta
saikin		akhir-akhir ini
tabun		mungkin, barangkali
kitto		pasti
hontouni	betul-betul
sonnani		tidak begitu (diikuti bentuk negatif)
~nitsuite	tentang ~, mengenai ~
hisashiburidesune 	sudah lama tidak bertemu ya
~demonomimasenka	Bagaimana kalau kita minum ~, atau apa saja?
mochiron	tentang saja
moukaeranaito	saya harus pulang








------------- Bab 23 ------------
kimasu		memakai(kemeja, atasan)
hakimasu	memakai(sepatu, celana)
kaburimasu	memakai(topi)
kakemasu	memakai(kacamata)
shimasu		memakai(dasi)
umaremasu	lahir

watashitachi	kami, kita
ko-to		mantel
seetaa		sweater, baju hangat
suutsu		pakaian setelan
boushi		topi
megane		kacamata
keeki		kue
[o]bentou	bekal
robotto		robot
yuumoa		humor
tsugou		kondisi
yoku		seringkali
eeto		itu...
omedetou[gozaimasu]	selamat(digunakan untuk hari ulang tahun, upacara pernikahan, dan tahun baru, dll)
osagashidesuka	mencari apa?
dewa		kalau begitu
kochira		ini (formal これ)

yachin		biaya sewa rumah
dainingukicchin	ruang makan dengan dapur
washitsu	kamar ala jepang
oshiire		lemari dinding ala jepang
futon		selimut dan kasur berisi kapas ala jepang











------------- Bab 24 ------------
kikimasu	bertanya (sensei ni kikimasu : bertanya kepada guru)
mawashimasu	memutar
hikimasu	tarik
kaemasu		mengubah
sawarimasu	menyentuh
demasu		keluar
otsuri		kembalian
arukimasu	berjalan kaki
watarimasu	menyeberang
magarimasu	belok
sabishii	sepi
mura		desa
hashi		jembatan
[o]yu		air panas
oto		suara, bunyi
saizu		ukuran

kosyou		kerusakan (~shimasu : rusak)
michi		jalan
kousaten	perempatan
shingou		lampu lalu lintas
kado		sudut
hashi		jembatan
cyuusyajyou	tempat parkir
tatemono	gedung
nankaimo	berkali-kali
~me		yang ke~ (mengungkapkan urutan)






------------- Bab 25 ------------
kuremasu	memberikan (orang lain)
naoshimasu	mengoreksi
tsureteikimasu	membawa, mengajak pergi
tsuretekimasu	membawa datang, mengajak datang
okurimasu	mengantar (hito wo okurimasu : mengantar orang)
syoukaishimasu	memperkenalkan
annaishimasu	mengantarkan
setsumeishimasu	menjelaskan, menerangkan

ojiisan		kakek
ojiichan	kakek
obaasan		nenek
obaachan	nenek
junbi		persiapan (~wo shimasu : mempersiapkan)
hikkoshi	pindah rumah (~wo shimasu : pindah, memindahkan)
okashi		camilan, snack
hoomusutei	homestay
zenbu		semua
jibunde		dengan sendiri
hokani		selain, yang lain









------------- Bab 26 ------------
kangaemasu	berpikir
tsukimasu	tiba, sampai
toshi wo torimasu	berumur, lanjut usia
tarimasu	cukup
inaka		desa, kampung halaman
chansu		kesempatan
oku		ratus juta
moshi[-tara]	kalau

imi		arti, makna
moshimoshi	halo (saat menelepon)
tenkin		pindah ke kantor cabang lain atau jabatan lain
koto		hal (~no koto : hal ~)
hima[na]	waktu luang
ganbarimasu	berusaha, bekerja keras
douzo ogenkide	semoga sehat selalu (digunakan ketika perpisahan dalam jangka waktu lama)
iroiro osewaninarimashita	terima kasih banyak atas bantuan anda yang telah anda berikan




------------------------------ N4 -------------------------------------
------------- Bab 1 ------------
運動会		うんどうかい	lomba olahraga
場所		ばしょ		tempat
財布		さいふ		dompet
平日		へいじつ	hari kerja
送れます	おくれます	terlambat
拾います	ひろいます	mengambil
~べん				dialek~
今度		こんど		lain kali, kali ini
直接		ちょくせつ	langsung
何でも		なんでも	apa saja
横		よこ		sebelah, samping
燃えるゴミ	もえるごみ	sampah organik
	
瓶		びん		botol
缶		かん		kaleng
~会社		~かいしゃ	perusahaan (ABC会社(がいしゃ)
宇宙		うちゅう	angkasa
怖い		こわい		takut
~様		~さま		kata hormat dari ~さん

見ます/診ます		みます		melihat/memeriksa
探します/捜します	さがします	mencari(keinginan)/mencari(tidak terlihat)
間に合います[時間に~]	まにあいます[じかんに~]		sempat(pada waktu)
やります	melakukan
連絡します	れんらくします	menghubungi
気分がいい	きぶんがいい	rasa enak, segar
気分悪い	きぶんわるい	rasa tidak enak
盆踊り		ぼんおどり	tarian Bon
フリーマーケット		pasar loak
ボランテiア	sukarelawan (volunteer)
ごみ		sampah
国会議事堂	こっかいぎじどう	gedung parlemen(nasional)
ずいぶん	sangat, amat
いつでも	kapanpun
どこでも	dimanapun
誰でも		だれでも	siapapun
こんな~		~ yang begini
そんな~		~ yang begitu
あんな~		~ yang begitu
片付きます[荷物が~]	かたづきます[にもつが~]		beres/tertata rapi[barang~]
かたづけます[荷物を~]	かたづけます[にもつを~]		membereskan[barang~]
置き場		おきば		tempat meletakkan (sesuatu)
ガス		gas
宇宙船		うちゅうせん	wahana antariksa, pesawat luar angkasa
宇宙飛行士	うちゅうひこうし	astronot
違います	ちがいます	tidak benar, berbeda




------------- Bab 2 ------------
飼います	かいます	untuk memelihara
走ります	はしります	berlari
見えます	みえます	terlihat
聞こえます	きこえます	terdengar
開きます	ひらきます	untuk membuka
心配		しんぱい	khawatir

花火		はなび		kembang api
道具		どうぐ		alat
家		いえ		rumah
教室		きょうしつ	ruang kelas
方		ほう		sisi
後		あと		setelah

他に		ほかに		lainnya
家具		かぐ		perabotan
本棚		ほんだな	rak buku
炊けます	たけます	membangung
素晴らしい	すばらしい	hebat
子供たち	こどもたち	anak-anak

できます[道が～]	できます[みちが～]	[jalan] dibuat
ペット		hewan peliharaan
鳥		とり		burung
声		こえ		suara
クリーニング	laundry
マンション	apartemen
キッチン	dapur
パーティールーム	ruang pesta
～後		～ご		setelah~, sesudah~
～しか		hanya~(dipakai dengan kata bentuk negatif)
ポケット	kantong
空		そら		langit
飛びます	とびます	terbang
昔		むかし		dulu, dahulu
自分		じぶん		diri sendiri
将来		しょうらい	masa depan



------------- Bab 3 ------------
熱心		ねっしん	tekun
景色		けしき		pemandangan
美容院		びよういん	salon kecantikan
台所		だいどころ	dapur
経験		けいけん	pengalaman
人気		にんき		populer

値段		ねだん		harga
給料		きゅうりょう	gaji
番組		ばんぐみ	acara TV
歌手		かしゅ		penyanyi
小説		しょうせつ	novel
息子		むすこ		anak laki-laki

会話		かいわ		percakapan
お知らせ	おしらせ	pemberitahuan/pengumuman
参加します	さんかします	mengikuti
体育館		たいいくかん	gedung olahraga
無料		むりょう	gratis, cuma-cuma
誘います	さそいます	mengajak

売れます[パンが～]	うれます[パンが～]	[roti] terjual
踊ります	おどります	menari
噛みます	かみます	mengunyah, menggigit
選びます	えらびます	memilih
通います[大学に～]	かよいます[だいがくに～]	pergi [ke universitas]
メモします	mencatat
まじめ[な]	serius
偉い		えらい		hebat
ちょうどいい	pas, tepat, cocok
力		ちから		kekuatan, tenaga
色		いろ		warna
味		あじ		rasa
ガム		がむ		permen karet
品物		しなもの	barang
ボーナス	bonus
ゲーム		game
ドラマ		drama, sinetron
小説家		しょうせつか	novelis
～家		～か		aliran~
～機		～き		mesin~
娘		むすめ		anak perempuan
息子さん	むすこさん	putra (di keluarga orang lain)
娘さん		むすめさん	putri (di keluarga orang lain)
しばらく	sebentar, sementara
たいてい	kebanyakan
それに		selain itu, dan juga
それで		dan, lalu
実は		じつは		sebenarnya
うーん		mmm...(bergumam)
[ちょっと]お願いがあるんですが。	[ちょっと]おねがいがあるんですが。	minta sesuatu [sebentar]
イベント	event, acara




------------- Bab 4 ------------
止まる		とまる		untuk berhenti
違い		ちがい		perbedaan
落とす		おとす		untuk menjatuhkan
かかる		memakan waktu
取る		とる		mengambil
皿		さら		piring

袋		ふくろ		kantong plastik, kantong kertas
書類		しょるい	dokumen
枝		えだ		cabang
駅員		えきいん	petugas stasiun
交番		こうばん	kantor polisi
返事		へんじ		menjawab
忘れ物		わすれもの	barang yang ketinggalan
確か		たしか		hal tentu
覚え		おぼえ		ingatan
開く		ひらく		membuka
閉める		しめる		menutup

壊れます	こわれます	rusak
割れます	われます	pecah
折れます	おれます	patah
破れます	やぶれます	sobek
汚れます	よごれます	menjadi kotor
付きます	つきます	terpasang
外れます	はずれます	terlepas
間違えます	まちがえます	salah, bersalah
拭きます	ふきます	mengelap
取り替えます	とりかえます	mengganti
おちゃわん	mangkuk
コップ		gelas
ガラス		glass, jendela
スピーチ	speech, pidato
~側		～がわ		sebelah~
～辺		～へん		sekitar~
網棚		あみだな	rak bagasi
地震		じしん		gempa bumi
壁		かべ		tembok, dinding
針		はり		jarum
指します	さします	menunjuk
倒れます	たおれます	tumbang, jatuh
燃えます	もえます	terbakar
西		にし		barat
駅前		えきまえ	depan stasiun
レポーター	reporter


------------- Bab 5 ------------
掛けます	かけます	menggantungkan
飾ります	かざります	menghiasi
予習		よしゅう	belajar persiapan
復習		ふくしゅう	belajar pengulangan
授業		じゅぎょう	kelas, pelajaran
講義		こうぎ		kuliah
人形		にんぎょう	boneka
花瓶		かびん		vas bunga
鏡		かがみ		cermin
予定表		よていひょう	jadwal acara
玄関		げんかん	teras, ruang depan
廊下		ろうか		koridor

隅		すみ		pojok, sudut
壁		かべ		dinding
池		いけ		kolam
非状袋		ひじょうぶくろ	kantong darurat
真ん中		まんなか	tengah
周り		まわり		sekitar

はります	menempelkan
並べます	ならべます	menata
植えます	うえます	menanam
戻します	もどします	mengembalikan
まとめます	merangkum
決めます	きめます	menentukan
そのままにします		membiarkan begitu
ミーティング	meeting, rapat
ガイドブック	buku panduan, buku petunjuk
カレンダー	kalender
ポスター	poster
ゴミ箱		ごみばこ	tempat sampah
引き出し	ひきだし	laci
元の所		もとのところ	tempat semula
リュック	ransel
非常時		ひじょうじ	saat darurat
生活します	せいかつします	hidup
懐中電灯	かいちゅうでんとう	senter
～とか、～とか		~atau~
丸い		まるい		bulat
ある～		suatu~
夢を見ます	ゆめをみます	bermimpi
うれしい	senang
嫌[な]		いや[な]	tidak suka
すると		kemudian
目を覚めます	めをさめます	bangun, sadar











------------ OTHER -------------
osu		menekan
sentaku		mencuci, laundry
yasui		murah
benri		praktis
pasokon		komputer, laptop
nichiyoubi	minggu
getsuyoubi	senin
kayoubi		selasa
suiyoubi	rabu
mokuyoubi	kamis
kinyoubi	jumat
doyoubi		sabtu
hatarakimasu	bekerja
omatsuri        festival
